###############
#      @      #
#h            #
#          ***#
#  #########  # 
#            h#
#***          #
#  #########  # 
#             #
#  bbbbbbbbb  #
#             #
# o         o #
##o#       #o##
#**#   x   #**#
###############