###############
#      @      #
#    b   b    #
# #         ###
# #    b    # #
# #    b    # #
# #    b    # #
# #    b    # #
#a#    b    # #
###h   b    # #
#             #
#           b #
######   ######
#x          o*#
###############
