###############
# @         x #
# ########### #
# # *  1  * # #
# #    b    # #
# #    r    # #
# #h  v v   # #
# ####o#o#### #
#    * b *    #
#   *  b  *   #
#             #
#    ##o##    #
#    #*e*#    #
#v   # 1 #   v#
###############