###############
#@    bbb     #
############# #
#v     *     h#
#b#    *     e#
#o#############
#h     *     v#
#      *#####b#
#########    o#
##2#       ####
#  #       ##*#
## ob      vv #
############# #
#x            #
###############