###############
#@           x#
############# #
#  *#  *#  *# #
# # # # # # # #
# # # # # # # #
# #  *#  *#   #
# #############
#b#ra#      *2#
#  #o#      **#
#  #b#     2  #
#             #
#             #
#            *#
###############
