###############
#@ ##########x#
#h            #
#h            #
#h            # 
#*#*#*#*#*#*# #
############r #
###*#*#*#*#*# #
#            h#
#       h     #
#  h          #
# ##*#*#*#*####
# #############
#h         bo*#
###############