###############
#@e    b   ox #
######   ######
#2#*       *#2#
#             #
# # # # # # # #
#  * * # * *  #
# # # # # # # #
#  * * # * *  #
# # # # # # # #
#             #
# #############
#    a r b o 1#
#        b o *#
###############