###############
#@           x#
#h           h#
####***b***####
#* ####o#### *# 
#      v      #
#             #
# ####   #### #
# #**#   #**# #
# ##o#   #o## #
#             #
# b         b #
# b         b #
#             #
###############