###############
#   @     x   #
############# #
#      h      #
#*#############
#   h         #
#############*#
#h            #
#*            #
######        #
#aaa*#  b b b #
#aeaa#  b b b #
#1 r #  b b b #
#     o#     *#
###############