###############
#      @      #
#             #
#      *      #
#      *      #
#      *      #
#      *      #
#      *      #
#             #
#    bbbbb    #
#             #
#  ####o####  #
#  #       #  #
#  #   x   #  #
###############