###############
#x@  bbabbo*a #
############# #
# *h         *#
#  *       h*v# 
#  v          #
#      ##     #
#           v #
# v*h       * #
# *         h*#
# #############
#  v       v v#
#    v   v  # #
#*     v    #e#
###############